11111111111111111111
10000000000000000001
10000000011000000001
10000000011002000001
10000000011000000001
10000000011000000001
10002000011000000001
10002000011000010001
10000000011000010001
10000000011000010001
10000000011111110001
10002000000000000001
10000000011000000001
10000000011000020001
10000001011000000001
10000000011000000001
10000000000000000001
10000000011000000001
11100100000000011001
11111111111111111111